HK______MnM_
SSSBS_SSSS__
B___SBS__S__
____SBS__S__
_B__SSS_KS__
__M______S__
_TBT__M__S__
_TTT__+-_B__
_________B__
BSSSSBBSSSB_
_V_____M____
___<___>_S__
