B__M_H__M_W__B
_SSSSSSSSSSSSB
M___T+T___-_B_
____T_T___ST_S
T____M________
T____<____TT__
T____M____TT__
SSB_BSSSSB__BS
______>_______
______V______M
S_____-_______