_V__SBS__S__M__
____SSSBKSSSSSS
____MM__BS_____
_TBT_____S_____
_TTT__+-_B__M__
__MMMM___S_-n__
_TBT_____S_____